14
14
wwwwwwwwwwwwww
w..p.........w
w....xx......w
wxO..OO..O...w
w........x...w
w............w
w............w
w............w
wxO.Oxx......w
wO........x.xw
w............w
w........O.O.w
w............w
wwwwwwwwwwwwww