10
9
wwwwwwwwww
wxxxO.O..w
wO.O.x.O.w
wx.O.x.Oxw
wx.x.O...w
wO..Ox.Oxw
w.p....O.w
w...xO.x.w
wwwwwwwwww